##########
#.@...$._#
#........#
#......$.#
#_.......#
##########